33333333333333333333333333333333333333333333333333333333333333333333333333333333333333333333333333333
/                                                                                                   \
\                                                                                                   /
/                                                                                                   \
\                                                                                                   /
/                                                                                                   \
\                                                                                                   /
/                                                                                                   \
\                                                                                                   /
/                                                                                                   \
\                                                                                                   /
/                                                                                                   \
\                                                                                                   /
/                                                                                                   \
\                                                                                                   /
/                                                                                                   \
\                                                                                                   /
/                                                                                                   \
\                                                                                                   /
/                                                                                                   \
33333333333333333333333333333333333333333333333333333333333333333333333333333333333333333333333333333