22222222222222222222222222222222222222222222222222222222222222222222222222222222222222222222222222222
/                                                                                                   \
\                                                                                                   /
/                                                                                                   \
\                                                                                                   /
/                                                                                                   \
\                                                                                                   /
/                                                                                                   \
\                                                                                                   /
/                                                                                                   \
\                                                                                                   /
/                                                                                                   \
\                                                                                                   /
/                                                                                                   \
\                                                                                                   /
/                                                                                                   \
\                                                                                                   /
/                                                                                                   \
\                                                                                                   /
/                                                                                                   \
22222222222222222222222222222222222222222222222222222222222222222222222222222222222222222222222222222