44444444444444444444444444444444444444444444444444444444444444444444444444444444444444444444444444444
/                                                                                                   \
\                                                                                                   /
/                                                                                                   \
\                                                                                                   /
/                                                                                                   \
\                                                                                                   /
/                                                                                                   \
\                                                                                                   /
/                                                                                                   \
\                                                                                                   /
/                                                                                                   \
\                                                                                                   /
/                                                                                                   \
\                                                                                                   /
/                                                                                                   \
\                                                                                                   /
/                                                                                                   \
\                                                                                                   /
/                                                                                                   \
44444444444444444444444444444444444444444444444444444444444444444444444444444444444444444444444444444